AH	AA
AND	AE N D
AND(1)	AH N D
AROUND	ER AW N D
AROUND(1)	ER AW N
END	EH N D
ER	ER
FIRST	F ER S T
GO	G OW
GUESS	G EH S
HALLWAY	HH AO L W EY
HAVE	HH AE V
I	AY
LEFT	L EH F T
MINUTE	M AY N Y UW T
MINUTE(1)	M AY N UW T
MINUTE(2)	M IH N AH T
MINUTES	M IH N AH T S
NO	N OW
OF	AH V
ONE	W AH N
ONE(1)	HH W AH N
SEVEN	S EH V AH N
SO	S OW
THE	DH AH
THE(1)	DH IY
THEN	DH EH N
TO	T AH
TO(1)	T IH
TO(2)	T UW
TURN	T ER N
UH	AH
UM	AH M
WE	W IY
YOU	Y UW
